#####################
#p   O ** *    *    #
# # S #*# # #*#*# # #
#   *     ***  *    #
# # # # # #*# # # # #
#     oS  S  **  B  #
# # F # F # # #B# # #
#*  *      *  *     #
# # # # #*# # # # # #
#* S  **  *         #
# #*# # # # # F # # #
#           *       #
# #*# # # # # # # # #
#      #            #
#####################

