#####################
# 2 *     ***  *    #
#*#*# # O #*# # # # #
#     *S  S  **  B  #
#      S  S  **  B  #
# # F # F # # #B# # #
#*  *      *  *   1 #
# # # # #*# # #*****#
#* S  **  *         #
# #*# # # # # F # # #
#           *       #
# #*# # * * # * # * #
#       * S  **  *  #
#*#*#*#*#*#*#*#*#*#*#
#      #            #
#####################
