#####################
#2  *     ***  *    #
# # # # # #*# # # # #
#     *S  S  **  B  #
#      S  S  **  B  #
# # F # F # # #B# # #
#*  *      *  *     #
# # # # #*# # #O****#
#* S  **  *         #
# #*# # # # # F # # #
#           *       #
# #*# # * * # * # * #
#       * S  **  1  #
#*#*#*#*#*#*#*#*#*#*#
#      #            #
#####################
