#####################
#p     ** *    *    #
# # S #*# # #*#*# # #
#   *     ***  *    #
# # # # # #*# # # # #
#      S  S  **  B  #
# # F # F # # #B# # #
#*  *   o  *  *     #
# # # # #*# # # # # #
#* S  **  *         #
# #*# # # # # F # # #
#           *       #
# #*# # # # # # # # #
#      #            #
#####################

