#####################
#   *     ***  *    #
# # # # # #*# # # # #
#     *S  S  **  B  #
#     oS  S  **  B  #
# # F # F # # #B# O #
#*  *      *  * S p #
# # # # #*# # #*****#
#* S  **  *         #
# #*# # # # # F # # #
#           *       #
# #*# # * * # * # * #
#       * S  **  *  #
#*#*#*#*#*#*#*#*#*#*#
#  b   #  o   o     #
#####################
