#####################
#   *     ***  *    #
# # # # # #*# # # # #
#     oS  S  **  B  #
#     *S  S  **  B  #
# # F # F # # #B# # #
#*  *      *  *   p #
# # # # #*# # # # # #
#* S  **  *         #
# #*# # # # # F # # #
#           *       #
# #*# # # # # # # # #
#      #            #
#*#*#*#*#*#*#*#*#*#*#
#  b   #  o   o     #
#####################
