#####################
#p   O ** *    *    #
# # S #*# # #*#*# # #
#   *     ***  *    #
# # # # # #*# # # # #
#     *S  S  **  B  #
# # F # F # # #B# # #
#*  *      *  *     #
# # # # #*# # # # # #
#* S  **  *         #
# #*# # # # # F # # #
#           *       #
#*#*#*#*#*#*#*#*#*#*#
#  b   #  o   o     #
#####################

