#####################
#   *  2  ***  *    #
#*#*#**# # #*# # # ##
#     *S oS  **  B  #
#     oS  S  **  B  #
#*#*F*# F # # #B# # #
#*  *         * 1  S#
# # # # #*# # #*O***#
#* S  **  *         #
# #*# # # # # F # # #
#           *       #
# #*# # * * # * # * #
#       * S  **  *  #
#*#*#*#*#*#*#*#*#*#*#
#  b   #  o   o     #
#####################
