#####################
#   *  2  ***  *    #
#*#*#**# # #*# # # ##
#     *S  S  **  B  #
#     oS  S  **  B  #
#*#*F*# F # # #B# # #
#*  *      *  * 1  S#
# # # # #*# # #*****#
#* S  **  *         #
# #*# # # # # F # # #
#           *       #
# #*# # * * # * # * #
#       * S  **  *  #
#*#*#*#*#*#*#*#*#*#*#
#  b   #  o   o     #
#####################
