#####################
#2  *     ***  *    #
# # # # # #*# # # # #
#     *S  S  **  B  #
#     oS  S  **  B  #
# # F # F # # #B# # #
#*  *      *  *     #
# # # # #*# # #O****#
#* S  **  *         #
# #*# # # # # F # # #
#           *       #
# #*# # * * # * # * #
#       * S  **  1  #
#*#*#*#*#*#*#*#*#*#*#
#  b   #  o   o     #
#####################
