#####################
#p     ** *    *    #
# # # #*# # #*#*# # #
#   *     ***  *    #
# # # # # #*# # # # #
#            **     #
# # # # # # # # # # #
#*  *   o  *  *     #
# # # # #*# # # # # #
#*    **  *         #
# #*# # # # # # # # #
#           *       #
# #*# # # # # # # # #
#      b            #
#####################

