#####################
#   *   B ***  *    #
#*#*#**# # #*# # # ##
#     *S  S  **  B  #
# # # oS# F  #*  B  #
#*#*F*# F # # #B# # #
#*  *         * 1  S#
# # # # #*# # #*O***#
#* S  **  B     L   #
# #*# # # # # F # # #
#    L   S  *   F   #
# #*B # * * # * # * #
# 2     * S  B*  *  #
#*#*#*#*#*#*#*#*#*#*#
#  b   #  o   o     #
#####################
