#####################
#p     ** *  1 * 2  #
# # # #*# # #*#*# # #
#  x*     ***  *    #
# # # # # #*# # # # #
#f         x **     #
# # # # # # # # # # #
#*  *      *  *     #
# # # # #*# # # # # #
#*    **  *         #
# #*# # # # # # # # #
#           *       #
# #*# # # # # # # # #
#                   #
#####################

